44 44 44 44 44 44 44 44 44 44 44 44 44 37 37 37 37 37 37 37 37 37 37
44 44 44 44 44 44 44 44 44 44 44 44 44 44 37 37 37 37 37 37 37 37 37
44 44 44 11 10 10 12 44 44 44 44 44 44 44 44 44 37 37 37 37 37 37 37
44 44 11 10 10 10 10 12 44 44 44 44 44 44 44 44 44 37 37 37 37 37 37
44 11 10 10 10 10 10 10 12 44 44 44 44 44 44 44 40 40 40 37 37 37 37
44 10 10 10 10 10 10 10 14 44 44 40 40 40 40 40 40 40 44 44 37 37 37
44 10 10 10 10 10 10 14 44 44 40 40 40 40 40 40 40 40 44 44 44 37 11
44 10 10 10 10 10 14 44 44 40 40 40 40 40 40 40 40 40 44 44 44 11 10
44 10 10 10 14 44 44 44 40 40 40 40 40 40 40 40 40 40 44 44 11 10 10
44 13 14 44 44 44 40 40 40 40 40 40 40 40 40 40 40 40 44 44 10 10 44
44 44 44 44 44 40 40 44 44 44 40 40 40 40 40 40 40 40 44 44 10 10 44
40 40 40 40 40 40 40 44 44 44 44 44 40 40 40 40 40 40 44 44 10 10 44
40 40 40 40 40 44 44 44 44 44 44 44 40 40 40 40 40 40 44 44 10 10 44
40 40 40 40 44 44 44 44 44 44 44 44 40 40 40 40 40 40 44 44 10 10 44
40 40 40 40 40 44 44 44 44 44 44 44 40 40 40 40 40 44 44 44 31 32 44
40 40 40 40 40 40 40 40 40 40 40 40 40 40 40 40 44 44 44 44 10 10 44
40 40 40 40 40 40 40 40 40 40 40 40 40 40 40 44 44 44 44 44 10 10 44
40 40 40 40 40 40 40 40 40 40 40 40 40 40 40 44 44 44 44 44 10 10 44
40 40 40 44 44 44 44 44 44 44 44 44 44 44 44 44 44 44 44 44 10 10 44
40 40 44 44 44 44 44 44 44 44 44 44 44 37 37 37 44 44 44 44 10 10 44
40 40 44 44 44 44 44 44 44 44 44 44 37 37 37 37 44 44 44 44 10 14 44
44 44 55 55 60 55 55 44 44 44 37 37 37 37 37 37 37 44 44 11 10 44 44
44 44 55 58 58 58 55 44 37 37 37 37 37 37 37 37 37 44 44 10 10 44 44
44 44 55 58 58 58 55 44 37 37 37 37 37 37 44 44 44 44 11 10 10 44 44
44 44 55 90 58 58 55 44 44 37 37 37 37 44 44 44 44 44 10 10 14 44 44
44 44 55 55 55 55 55 44 44 37 37 37 37 44 44 44 44 44 10 10 44 44 44
44 44 44 44 44 44 44 44 44 37 37 37 37 44 44 44 44 11 10 10 44 44 44
44 44 44 44 44 44 44 44 44 37 37 37 44 44 44 44 44 10 10 10 44 44 44